1111111111111111111111111111111111111111111111
111111E000000000000000000000000000000000000001
11010X0011111111111111111111111111111111111111
1110C00111111111111111111111111111111111111111
1110P01111111111111111111111111111111111111111
1111111111111111111111111111111111111111111111
