11111111111111
1C00C00010C001
10100010000001
1000C0E0000001
10000010000001
10000110000001
10000000P00C01
10000000000001
1000000X000001
10000000000001
11111111111111
