111111
11C001
100001
1C00P1
111111
