111 1
1P1 1
1C1 1
101 1
1E1 1
111 1
11111
