1111111111
1000000011
1010001001
1000C0E001
1000001001
1000011001
10000000P1
1111111111