111111
1P1111
1C1111
101111
1E1111
111111