111111
11C001
100001
1C0EP1
111111
