111111
110C01
100001
1C0EP1
111111
