111111
11P0011
100C11
1E1111
111101
111111
